111111111111111111111
10F0T0F0100010F00TF01
101111101011111011101
100T001010FT001010F01
10111011111110111B111
1010F010FT0010F010001
1110111010111110111G1
100010F010F0TF00100T1
1G111011111111111G101
101000100T0F00T000101
1T1011111111111110111
1T100F0T000010F010F01
101111111110101010101
10F0000TF01000101T101
101011101111111T10101
1010001010T00010101T1
101110101011101010101
1010101R100010F010101
10101G111110111111101
100010000TF0000T00F01
111111111111111111111