111111111111111111111
1F00T0F0100010F00T001
101111101011111011101
100T0010100T001010F01
10111011111110111B111
1010F0100T00100010001
111011101011111011101
10F010F01000T0F0100T1
101110111111111110101
101000100T00F0T000101
1T1011111111111110111
1T10000TF00010F010001
101110101011101010101
1010101R100010F010101
101010111110111111101
1F0010000T00F00T00F01
111111111111111111111