111111111111111111111
100000001000100000001
101111101011111011101
100000101000001010001
101110111111101110111
101000100000100010001
111011101011111011101
100010001000000010001
101110111111111110101
101000100000000000101
101011111111111110111
101000000000100010001
101111111110101010101
100000000010001010101
101011101111111010101
101000101000001010101
101110101011101010101
101010101000100010101
101010111110111111101
100010000000000000001
111111111111111111111