111111111111111111111
1000T000100010000T001
101111101011111011101
100T0010100T001010001
10111011111110111B111
101000100T00100010001
111011101011111011101
100010001000T000100T1
101110111111111110101
101000100T0000T000101
1T1011111111111110111
1T10000T0000100010001
101111111110101010101
1000000T001000101T101
101011101111111T10101
1010001010T00010101T1
101110101011101010101
1010101R1000100010101
101010111110111111101
100010000T00000T00001
111111111111111111111